5 9 9 9 9 9 9 9 9 9 9 9 9 9 9 6
7 10 10 10 10 10 10 10 10 10 10 10 10 10 10 8
3 0 0 0 0 0 0 0 0 0 0 0 0 0 0 11
3 0 0 0 0 0 0 0 0 0 0 0 0 0 0 11
3 0 0 0 0 0 0 0 0 0 0 0 0 0 0 11
3 0 0 0 0 0 0 0 0 0 0 0 0 0 0 11
4 0 0 0 0 0 0 0 0 0 0 0 0 0 0 11
1 0 0 0 0 0 0 0 0 0 0 0 0 0 0 11
1 0 0 0 0 0 0 0 0 0 0 0 0 0 0 11
2 0 0 0 0 0 0 0 0 0 0 0 0 0 0 11
3 0 0 0 0 0 0 0 0 0 0 0 0 0 0 11
3 0 0 0 0 0 0 0 0 0 0 0 0 0 0 11



